1111111111111111111111111111
1CCCE1CCCCCCCCCCCCCCCC1ECCC1
100000CCCCCPPPPPPCCCCC000001
1111111111111111111111111111